228 20
9	9	9	9	9	9	9	9	9	9	9	9	9	9	9	9	9	9	9	9
1	1	1	1	1	1	2	2	2	2	3	3	3	3	8	8	8	8	9	9
1	1	1	1	1	1	2	2	2	2	3	3	3	3	8	8	8	8	9	9
6	6	1	1	5	5	5	5	2	2	3	3	1	1	8	8	8	8	1	1
6	6	1	1	5	5	5	5	2	2	3	3	1	1	8	8	8	8	1	1
6	6	6	6	5	5	5	5	2	2	1	1	1	1	3	3	3	3	1	1
6	6	6	6	5	5	5	5	2	2	1	1	1	1	3	3	3	3	1	1
6	6	7	7	7	7	1	1	6	6	2	2	1	1	3	3	3	3	1	1
6	6	7	7	7	7	1	1	6	6	2	2	1	1	3	3	3	3	1	1
8	8	7	7	7	7	1	1	6	6	2	2	2	2	2	2	6	6	1	1
8	8	7	7	7	7	1	1	6	6	2	2	2	2	2	2	6	6	1	1
8	8	4	4	4	4	1	1	6	6	6	6	5	5	5	5	6	6	6	6
8	8	4	4	4	4	1	1	6	6	6	6	5	5	5	5	6	6	6	6
1	1	4	4	4	4	1	1	3	3	2	2	5	5	5	5	6	6	5	5
1	1	4	4	4	4	1	1	3	3	2	2	5	5	5	5	6	6	5	5
1	1	2	2	2	2	2	2	3	3	2	2	2	2	4	4	5	5	5	5
1	1	2	2	2	2	2	2	3	3	2	2	2	2	4	4	5	5	5	5
1	1	1	1	2	2	3	3	3	3	2	2	4	4	4	4	4	4	5	5
1	1	1	1	2	2	3	3	3	3	2	2	4	4	4	4	4	4	5	5
9	9	9	9	9	9	9	9	9	9	9	9	9	9	9	9	9	9	9	9
1	1	1	1	1	1	2	2	2	2	3	3	3	3	8	8	8	8	9	9
1	1	1	1	1	1	2	2	2	2	3	3	3	3	8	8	8	8	9	9
6	6	1	1	5	5	5	5	2	2	3	3	1	1	8	8	8	8	1	1
6	6	1	1	5	5	5	5	2	2	3	3	1	1	8	8	8	8	1	1
6	6	6	6	5	5	5	5	2	2	1	1	1	1	3	3	3	3	1	1
6	6	6	6	5	5	5	5	2	2	1	1	1	1	3	3	3	3	1	1
6	6	7	7	7	7	1	1	6	6	2	2	1	1	3	3	3	3	1	1
6	6	7	7	7	7	1	1	6	6	2	2	1	1	3	3	3	3	1	1
8	8	7	7	7	7	1	1	6	6	2	2	2	2	2	2	6	6	1	1
8	8	7	7	7	7	1	1	6	6	2	2	2	2	2	2	6	6	1	1
8	8	4	4	4	4	1	1	6	6	6	6	5	5	5	5	6	6	6	6
8	8	4	4	4	4	1	1	6	6	6	6	5	5	5	5	6	6	6	6
1	1	4	4	4	4	1	1	3	3	2	2	5	5	5	5	6	6	5	5
1	1	4	4	4	4	1	1	3	3	2	2	5	5	5	5	6	6	5	5
1	1	2	2	2	2	2	2	3	3	2	2	2	2	4	4	5	5	5	5
1	1	2	2	2	2	2	2	3	3	2	2	2	2	4	4	5	5	5	5
1	1	1	1	2	2	3	3	3	3	2	2	4	4	4	4	4	4	5	5
1	1	1	1	2	2	3	3	3	3	2	2	4	4	4	4	4	4	5	5
9	9	9	9	9	9	9	9	9	9	9	9	9	9	9	9	9	9	9	9
1	1	1	1	1	1	2	2	2	2	3	3	3	3	8	8	8	8	9	9
1	1	1	1	1	1	2	2	2	2	3	3	3	3	8	8	8	8	9	9
6	6	1	1	5	5	5	5	2	2	3	3	1	1	8	8	8	8	1	1
6	6	1	1	5	5	5	5	2	2	3	3	1	1	8	8	8	8	1	1
6	6	6	6	5	5	5	5	2	2	1	1	1	1	3	3	3	3	1	1
6	6	6	6	5	5	5	5	2	2	1	1	1	1	3	3	3	3	1	1
6	6	7	7	7	7	1	1	6	6	2	2	1	1	3	3	3	3	1	1
6	6	7	7	7	7	1	1	6	6	2	2	1	1	3	3	3	3	1	1
8	8	7	7	7	7	1	1	6	6	2	2	2	2	2	2	6	6	1	1
8	8	7	7	7	7	1	1	6	6	2	2	2	2	2	2	6	6	1	1
8	8	4	4	4	4	1	1	6	6	6	6	5	5	5	5	6	6	6	6
8	8	4	4	4	4	1	1	6	6	6	6	5	5	5	5	6	6	6	6
1	1	4	4	4	4	1	1	3	3	2	2	5	5	5	5	6	6	5	5
1	1	4	4	4	4	1	1	3	3	2	2	5	5	5	5	6	6	5	5
1	1	2	2	2	2	2	2	3	3	2	2	2	2	4	4	5	5	5	5
1	1	2	2	2	2	2	2	3	3	2	2	2	2	4	4	5	5	5	5
1	1	1	1	2	2	3	3	3	3	2	2	4	4	4	4	4	4	5	5
1	1	1	1	2	2	3	3	3	3	2	2	4	4	4	4	4	4	5	5
9	9	9	9	9	9	9	9	9	9	9	9	9	9	9	9	9	9	9	9
1	1	1	1	1	1	2	2	2	2	3	3	3	3	8	8	8	8	9	9
1	1	1	1	1	1	2	2	2	2	3	3	3	3	8	8	8	8	9	9
6	6	1	1	5	5	5	5	2	2	3	3	1	1	8	8	8	8	1	1
6	6	1	1	5	5	5	5	2	2	3	3	1	1	8	8	8	8	1	1
6	6	6	6	5	5	5	5	2	2	1	1	1	1	3	3	3	3	1	1
6	6	6	6	5	5	5	5	2	2	1	1	1	1	3	3	3	3	1	1
6	6	7	7	7	7	1	1	6	6	2	2	1	1	3	3	3	3	1	1
6	6	7	7	7	7	1	1	6	6	2	2	1	1	3	3	3	3	1	1
8	8	7	7	7	7	1	1	6	6	2	2	2	2	2	2	6	6	1	1
8	8	7	7	7	7	1	1	6	6	2	2	2	2	2	2	6	6	1	1
8	8	4	4	4	4	1	1	6	6	6	6	5	5	5	5	6	6	6	6
8	8	4	4	4	4	1	1	6	6	6	6	5	5	5	5	6	6	6	6
1	1	4	4	4	4	1	1	3	3	2	2	5	5	5	5	6	6	5	5
1	1	4	4	4	4	1	1	3	3	2	2	5	5	5	5	6	6	5	5
1	1	2	2	2	2	2	2	3	3	2	2	2	2	4	4	5	5	5	5
1	1	2	2	2	2	2	2	3	3	2	2	2	2	4	4	5	5	5	5
1	1	1	1	2	2	3	3	3	3	2	2	4	4	4	4	4	4	5	5
1	1	1	1	2	2	3	3	3	3	2	2	4	4	4	4	4	4	5	5
9	9	9	9	9	9	9	9	9	9	9	9	9	9	9	9	9	9	9	9
1	1	1	1	1	1	2	2	2	2	3	3	3	3	8	8	8	8	9	9
1	1	1	1	1	1	2	2	2	2	3	3	3	3	8	8	8	8	9	9
6	6	1	1	5	5	5	5	2	2	3	3	1	1	8	8	8	8	1	1
6	6	1	1	5	5	5	5	2	2	3	3	1	1	8	8	8	8	1	1
6	6	6	6	5	5	5	5	2	2	1	1	1	1	3	3	3	3	1	1
6	6	6	6	5	5	5	5	2	2	1	1	1	1	3	3	3	3	1	1
6	6	7	7	7	7	1	1	6	6	2	2	1	1	3	3	3	3	1	1
6	6	7	7	7	7	1	1	6	6	2	2	1	1	3	3	3	3	1	1
8	8	7	7	7	7	1	1	6	6	2	2	2	2	2	2	6	6	1	1
8	8	7	7	7	7	1	1	6	6	2	2	2	2	2	2	6	6	1	1
8	8	4	4	4	4	1	1	6	6	6	6	5	5	5	5	6	6	6	6
8	8	4	4	4	4	1	1	6	6	6	6	5	5	5	5	6	6	6	6
1	1	4	4	4	4	1	1	3	3	2	2	5	5	5	5	6	6	5	5
1	1	4	4	4	4	1	1	3	3	2	2	5	5	5	5	6	6	5	5
1	1	2	2	2	2	2	2	3	3	2	2	2	2	4	4	5	5	5	5
1	1	2	2	2	2	2	2	3	3	2	2	2	2	4	4	5	5	5	5
1	1	1	1	2	2	3	3	3	3	2	2	4	4	4	4	4	4	5	5
1	1	1	1	2	2	3	3	3	3	2	2	4	4	4	4	4	4	5	5
9	9	9	9	9	9	9	9	9	9	9	9	9	9	9	9	9	9	9	9
1	1	1	1	1	1	2	2	2	2	3	3	3	3	8	8	8	8	9	9
1	1	1	1	1	1	2	2	2	2	3	3	3	3	8	8	8	8	9	9
6	6	1	1	5	5	5	5	2	2	3	3	1	1	8	8	8	8	1	1
6	6	1	1	5	5	5	5	2	2	3	3	1	1	8	8	8	8	1	1
6	6	6	6	5	5	5	5	2	2	1	1	1	1	3	3	3	3	1	1
6	6	6	6	5	5	5	5	2	2	1	1	1	1	3	3	3	3	1	1
6	6	7	7	7	7	1	1	6	6	2	2	1	1	3	3	3	3	1	1
6	6	7	7	7	7	1	1	6	6	2	2	1	1	3	3	3	3	1	1
8	8	7	7	7	7	1	1	6	6	2	2	2	2	2	2	6	6	1	1
8	8	7	7	7	7	1	1	6	6	2	2	2	2	2	2	6	6	1	1
8	8	4	4	4	4	1	1	6	6	6	6	5	5	5	5	6	6	6	6
8	8	4	4	4	4	1	1	6	6	6	6	5	5	5	5	6	6	6	6
1	1	4	4	4	4	1	1	3	3	2	2	5	5	5	5	6	6	5	5
1	1	4	4	4	4	1	1	3	3	2	2	5	5	5	5	6	6	5	5
1	1	2	2	2	2	2	2	3	3	2	2	2	2	4	4	5	5	5	5
1	1	2	2	2	2	2	2	3	3	2	2	2	2	4	4	5	5	5	5
1	1	1	1	2	2	3	3	3	3	2	2	4	4	4	4	4	4	5	5
1	1	1	1	2	2	3	3	3	3	2	2	4	4	4	4	4	4	5	5
9	9	9	9	9	9	9	9	9	9	9	9	9	9	9	9	9	9	9	9
1	1	1	1	1	1	2	2	2	2	3	3	3	3	8	8	8	8	9	9
1	1	1	1	1	1	2	2	2	2	3	3	3	3	8	8	8	8	9	9
6	6	1	1	5	5	5	5	2	2	3	3	1	1	8	8	8	8	1	1
6	6	1	1	5	5	5	5	2	2	3	3	1	1	8	8	8	8	1	1
6	6	6	6	5	5	5	5	2	2	1	1	1	1	3	3	3	3	1	1
6	6	6	6	5	5	5	5	2	2	1	1	1	1	3	3	3	3	1	1
6	6	7	7	7	7	1	1	6	6	2	2	1	1	3	3	3	3	1	1
6	6	7	7	7	7	1	1	6	6	2	2	1	1	3	3	3	3	1	1
8	8	7	7	7	7	1	1	6	6	2	2	2	2	2	2	6	6	1	1
8	8	7	7	7	7	1	1	6	6	2	2	2	2	2	2	6	6	1	1
8	8	4	4	4	4	1	1	6	6	6	6	5	5	5	5	6	6	6	6
8	8	4	4	4	4	1	1	6	6	6	6	5	5	5	5	6	6	6	6
1	1	4	4	4	4	1	1	3	3	2	2	5	5	5	5	6	6	5	5
1	1	4	4	4	4	1	1	3	3	2	2	5	5	5	5	6	6	5	5
1	1	2	2	2	2	2	2	3	3	2	2	2	2	4	4	5	5	5	5
1	1	2	2	2	2	2	2	3	3	2	2	2	2	4	4	5	5	5	5
1	1	1	1	2	2	3	3	3	3	2	2	4	4	4	4	4	4	5	5
1	1	1	1	2	2	3	3	3	3	2	2	4	4	4	4	4	4	5	5
9	9	9	9	9	9	9	9	9	9	9	9	9	9	9	9	9	9	9	9
1	1	1	1	1	1	2	2	2	2	3	3	3	3	8	8	8	8	9	9
1	1	1	1	1	1	2	2	2	2	3	3	3	3	8	8	8	8	9	9
6	6	1	1	5	5	5	5	2	2	3	3	1	1	8	8	8	8	1	1
6	6	1	1	5	5	5	5	2	2	3	3	1	1	8	8	8	8	1	1
6	6	6	6	5	5	5	5	2	2	1	1	1	1	3	3	3	3	1	1
6	6	6	6	5	5	5	5	2	2	1	1	1	1	3	3	3	3	1	1
6	6	7	7	7	7	1	1	6	6	2	2	1	1	3	3	3	3	1	1
6	6	7	7	7	7	1	1	6	6	2	2	1	1	3	3	3	3	1	1
8	8	7	7	7	7	1	1	6	6	2	2	2	2	2	2	6	6	1	1
8	8	7	7	7	7	1	1	6	6	2	2	2	2	2	2	6	6	1	1
8	8	4	4	4	4	1	1	6	6	6	6	5	5	5	5	6	6	6	6
8	8	4	4	4	4	1	1	6	6	6	6	5	5	5	5	6	6	6	6
1	1	4	4	4	4	1	1	3	3	2	2	5	5	5	5	6	6	5	5
1	1	4	4	4	4	1	1	3	3	2	2	5	5	5	5	6	6	5	5
1	1	2	2	2	2	2	2	3	3	2	2	2	2	4	4	5	5	5	5
1	1	2	2	2	2	2	2	3	3	2	2	2	2	4	4	5	5	5	5
1	1	1	1	2	2	3	3	3	3	2	2	4	4	4	4	4	4	5	5
1	1	1	1	2	2	3	3	3	3	2	2	4	4	4	4	4	4	5	5
9	9	9	9	9	9	9	9	9	9	9	9	9	9	9	9	9	9	9	9
1	1	1	1	1	1	2	2	2	2	3	3	3	3	8	8	8	8	9	9
1	1	1	1	1	1	2	2	2	2	3	3	3	3	8	8	8	8	9	9
6	6	1	1	5	5	5	5	2	2	3	3	1	1	8	8	8	8	1	1
6	6	1	1	5	5	5	5	2	2	3	3	1	1	8	8	8	8	1	1
6	6	6	6	5	5	5	5	2	2	1	1	1	1	3	3	3	3	1	1
6	6	6	6	5	5	5	5	2	2	1	1	1	1	3	3	3	3	1	1
6	6	7	7	7	7	1	1	6	6	2	2	1	1	3	3	3	3	1	1
6	6	7	7	7	7	1	1	6	6	2	2	1	1	3	3	3	3	1	1
8	8	7	7	7	7	1	1	6	6	2	2	2	2	2	2	6	6	1	1
8	8	7	7	7	7	1	1	6	6	2	2	2	2	2	2	6	6	1	1
8	8	4	4	4	4	1	1	6	6	6	6	5	5	5	5	6	6	6	6
8	8	4	4	4	4	1	1	6	6	6	6	5	5	5	5	6	6	6	6
1	1	4	4	4	4	1	1	3	3	2	2	5	5	5	5	6	6	5	5
1	1	4	4	4	4	1	1	3	3	2	2	5	5	5	5	6	6	5	5
1	1	2	2	2	2	2	2	3	3	2	2	2	2	4	4	5	5	5	5
1	1	2	2	2	2	2	2	3	3	2	2	2	2	4	4	5	5	5	5
1	1	1	1	2	2	3	3	3	3	2	2	4	4	4	4	4	4	5	5
1	1	1	1	2	2	3	3	3	3	2	2	4	4	4	4	4	4	5	5
9	9	9	9	9	9	9	9	9	9	9	9	9	9	9	9	9	9	9	9
1	1	1	1	1	1	2	2	2	2	3	3	3	3	8	8	8	8	9	9
1	1	1	1	1	1	2	2	2	2	3	3	3	3	8	8	8	8	9	9
6	6	1	1	5	5	5	5	2	2	3	3	1	1	8	8	8	8	1	1
6	6	1	1	5	5	5	5	2	2	3	3	1	1	8	8	8	8	1	1
6	6	6	6	5	5	5	5	2	2	1	1	1	1	3	3	3	3	1	1
6	6	6	6	5	5	5	5	2	2	1	1	1	1	3	3	3	3	1	1
6	6	7	7	7	7	1	1	6	6	2	2	1	1	3	3	3	3	1	1
6	6	7	7	7	7	1	1	6	6	2	2	1	1	3	3	3	3	1	1
8	8	7	7	7	7	1	1	6	6	2	2	2	2	2	2	6	6	1	1
8	8	7	7	7	7	1	1	6	6	2	2	2	2	2	2	6	6	1	1
8	8	4	4	4	4	1	1	6	6	6	6	5	5	5	5	6	6	6	6
8	8	4	4	4	4	1	1	6	6	6	6	5	5	5	5	6	6	6	6
1	1	4	4	4	4	1	1	3	3	2	2	5	5	5	5	6	6	5	5
1	1	4	4	4	4	1	1	3	3	2	2	5	5	5	5	6	6	5	5
1	1	2	2	2	2	2	2	3	3	2	2	2	2	4	4	5	5	5	5
1	1	2	2	2	2	2	2	3	3	2	2	2	2	4	4	5	5	5	5
1	1	1	1	2	2	3	3	3	3	2	2	4	4	4	4	4	4	5	5
1	1	1	1	2	2	3	3	3	3	2	2	4	4	4	4	4	4	5	5
9	9	9	9	9	9	9	9	9	9	9	9	9	9	9	9	9	9	9	9
1	1	1	1	1	1	2	2	2	2	3	3	3	3	8	8	8	8	9	9
1	1	1	1	1	1	2	2	2	2	3	3	3	3	8	8	8	8	9	9
6	6	1	1	5	5	5	5	2	2	3	3	1	1	8	8	8	8	1	1
6	6	1	1	5	5	5	5	2	2	3	3	1	1	8	8	8	8	1	1
6	6	6	6	5	5	5	5	2	2	1	1	1	1	3	3	3	3	1	1
6	6	6	6	5	5	5	5	2	2	1	1	1	1	3	3	3	3	1	1
6	6	7	7	7	7	1	1	6	6	2	2	1	1	3	3	3	3	1	1
6	6	7	7	7	7	1	1	6	6	2	2	1	1	3	3	3	3	1	1
8	8	7	7	7	7	1	1	6	6	2	2	2	2	2	2	6	6	1	1
8	8	7	7	7	7	1	1	6	6	2	2	2	2	2	2	6	6	1	1
8	8	4	4	4	4	1	1	6	6	6	6	5	5	5	5	6	6	6	6
8	8	4	4	4	4	1	1	6	6	6	6	5	5	5	5	6	6	6	6
1	1	4	4	4	4	1	1	3	3	2	2	5	5	5	5	6	6	5	5
1	1	4	4	4	4	1	1	3	3	2	2	5	5	5	5	6	6	5	5
1	1	2	2	2	2	2	2	3	3	2	2	2	2	4	4	5	5	5	5
1	1	2	2	2	2	2	2	3	3	2	2	2	2	4	4	5	5	5	5
1	1	1	1	2	2	3	3	3	3	2	2	4	4	4	4	4	4	5	5
1	1	1	1	2	2	3	3	3	3	2	2	4	4	4	4	4	4	5	5
9	9	9	9	9	9	9	9	9	9	9	9	9	9	9	9	9	9	9	9
1	1	1	1	1	1	2	2	2	2	3	3	3	3	8	8	8	8	9	9
1	1	1	1	1	1	2	2	2	2	3	3	3	3	8	8	8	8	9	9
6	6	1	1	5	5	5	5	2	2	3	3	1	1	8	8	8	8	1	1
6	6	1	1	5	5	5	5	2	2	3	3	1	1	8	8	8	8	1	1
6	6	6	6	5	5	5	5	2	2	1	1	1	1	3	3	3	3	1	1
6	6	6	6	5	5	5	5	2	2	1	1	1	1	3	3	3	3	1	1
6	6	7	7	7	7	1	1	6	6	2	2	1	1	3	3	3	3	1	1
6	6	7	7	7	7	1	1	6	6	2	2	1	1	3	3	3	3	1	1
8	8	7	7	7	7	1	1	6	6	2	2	2	2	2	2	6	6	1	1
8	8	7	7	7	7	1	1	6	6	2	2	2	2	2	2	6	6	1	1
8	8	4	4	4	4	1	1	6	6	6	6	5	5	5	5	6	6	6	6
8	8	4	4	4	4	1	1	6	6	6	6	5	5	5	5	6	6	6	6
1	1	4	4	4	4	1	1	3	3	2	2	5	5	5	5	6	6	5	5
1	1	4	4	4	4	1	1	3	3	2	2	5	5	5	5	6	6	5	5
1	1	2	2	2	2	2	2	3	3	2	2	2	2	4	4	5	5	5	5
1	1	2	2	2	2	2	2	3	3	2	2	2	2	4	4	5	5	5	5
1	1	1	1	2	2	3	3	3	3	2	2	4	4	4	4	4	4	5	5
1	1	1	1	2	2	3	3	3	3	2	2	4	4	4	4	4	4	5	5
